Palaeograph	Palaeogmphy
y,	,
Pataeoctimatology	Palaeoclimatology
Paiaeoecoiogy,'	Palaeoecologyf
liverpool	Liverpool
??trilobite	trilobite
community	oommunity
Paiaeogeogr.	Palaeogeogr.
Palaeoclimatol	Palaeoclimatot
Paiaeoecoi.	Palaeoeco1.
tenuigranuiata	tenuigranulata
essentialiy	essentially
Lingulasrna	Lingulasma
??trilobite	trilobite
??bivalve	bivalve
tenuigranuiata	tenuigranulata
sh<lf	shell
.nviron-ment	vnvironment
conduciveto	conducivewto
M'Coy	M?Coy
's	?s
Lingu!a	Lingula
tenuigranuittta	tenuigranulata
.l	.1
%aagen	Waagen
internal	intemal
external	extemal
Linguta	Lingula
tenuigranulata	tenuzjgranulata
Meifod.	Meifod
Feil	Fell
lnlier	Inlier
R	R.
K	K.
PICKERILI?	PICKERILL
conspecific	conspeci?c
cunadense	aanadense
Lingu!a	Lingula
tenuigranulata.	tenuigmnulata
tenuigrunulata	tenuigranulata
?	6
?6%	%
l	]
tenutgranulata	Ienuigranulata
Inchned	Inclined
Lingutasma	Lingulasma
5	S
siliciftcation	silici?cation
phosphatisa-tion	phosphatisation
10	l0
??20	20
umts.	units
tenuigranulrrta	tenuigranulata
UJASMA	ULASMA
TENUEGRANULA	TENUIGRANULA
confined	con?ned
?re	are
pre-dominantly	predominantly
PALAEOECOLOGY	PALAEOBCOLOGY
inchned	Inclined
obhque	oblique
Iingulasma	Lingulasma
's	?s
difficult	dif?cult
recon-structio	reconstruction
n,	,
qualiTied	quali?ed
Ptatystrophia	Platystrophia
commissure	comrnissure
1963???Carbonifer	1963Carboniferous
ous,	,
concerne	concemed
d,	,
L	L.
's	?s
filter-feede	?lter-feeder
r.	.
al	a1
??water	water
??trilobite	trilobite
i	]
?uculopsis	Nuculopsis
squamt'formis	Squamiformis
Sanguinolites	Sanguinolires
Posldorlia	Posidonia
conctnnus	concinnus
Wayiandella	Warykmdella
a.l	al.
l968	1968
decemp/icata	decemplicata
Pa/aeonei/o	Palaeoneilo
Pferonite//a	Pteronirella
retroflexa	retro?exa
Cornu/ites	Cornulites
pseudopara//e/a	pseudoparallela
Hryo	Bryo
1969a	196921
Tancredlopsls	Tancrediopsis
Lingu/a	Lingula
P/ectonotus	Plectonotus
Ischyrodonr	Ischyrodoma
a~	?
Bucania	Bucanfa
Stratght	Straight
Vertical	vertical
burro%	burrow
?ico/e//a	Nicolella
P/atystrophia	Platystrophia
Dalmanella	Dalmzmella
Kr'aeromena	Kiaeromena
kjeru/fi	kjerul?
Blcusppta	Bicuspina
s/nrlferoldes	spiriferoides
Lingu/agma	Lingulasma
tenuigranulata	tenuigmnulata
a/lfpons	alifrons
SErophomena	Strophomena
Eop/ectodonta	Eoplectodonta
swRllQ%'cI'	swallower
UflkBQ%'A	unknown
BXB,	Bra
C41Gp()dR	chiopoda
defined	de?ned
iii	in
??trilobite	trilobite
L	L.
Pen-y<amedd	Pen-y-Gamedd
L	L.
Linguia	Lingula
concerning	conceming
medium-sized	mediumsized
L	L.
1	l
L	L.
tenuigranulata,	tenurjgrrmulata
L	L.
Pen-y-Garnedd	PenyGamedd
pyrarnidata	pyramidata
glCl	Lengthcm
0	o
Width	VV-dth
L	L.
tenuigranulata	tenuigranuhzta
Lingulasma	Lingukzsma
L	L.
Pen-y-Garnedd	Pen-y-Gamedd
Cardiurn	Cardium
Jlfytilus	Mytilus
L	L.
tenuigranulata	tenuigranukzta
environ-ment	environment
coalfield	coal?eld
J..	L.
normally	nonnally
microgram/annum	micfogram/annum
current-swept	currentswept
l5	15
infilled	in?lled
5	S
??10	lo
insufficient	insuf?cient
Pen-y&arnedd	Pen-y-Garnedd
bY	by
m,	in
up-ward	upward
well-developed	welldeveloped
R	R.
L	L.
patterns	pattems
strophomenid???trilobite	strophomenidtrilobite
of	Of
sp	SP
e	?
ci	Ci
e	?
s	-
's	?s
filter-feede	?lter-feeder
r.	.
I.ingulasma	Lingukzsma
I..	L.
renuigranulafa	tenuigranulata
N.E,R.C.	N.E.R.C.
Palaeogeogr.	Palaeogeogtz
143???1	143-172
72.	,
1	l
1420???14	1420-1431
31.	.
9???	9-47
47.	.
L	J.
239???2	239-281
81.	.
Caradoc	Camdoc
GeoL	Geol
Palaeogeogn	PaIaeogeogr
Palaeoclimatol	Pataeoclimatol
???	-59
59.	.
Jvorsk	Norsk
Tidsskr.	Tidsskrz
I	1
397???4	397-414
14.	.
iifi	Misc
sc.	.
Collect.	CoIlect.
??x	xvi
v	)
i):	:
palaeoecology	palacoecology
111???1	111-119
19.	.
palaeoecology	palacoecology
103???1	103-109
09.	.
I???2	1-248
48.	.
GeoL	Geol
palaeoecology	palacoecology
L	J.
palaeoecology	palacoecology
stluamiformis	squamiformis
L	J.
669???6	669-681
81.	.
%em.	Mem.
Palaeontol.	PaIaeontoI.
???	-98
98.	.
Population	Popuktions
s.	.
29???	29-51
5I.	.
FIata	Hatai
i,	,
Jap	lap
GeoL	Geol
Intersperific	lnterspecific
???	-55
55.	.
Imbrie	lmbrie
Approuches	Approaches
107???1	107-134
34.	.
0.	Q.
671???7	671-704
04.	.
K	K.
M'Coy	M?Coy
Palueozoic	Palaeozoic
Cumbridge	Cambridge
407???6	407-601
01.	.
GeoL	Geol
Nomura	Nomuta
Hatai,	I-latai
Honsyu,	l-lonsyu
Suito	Saito
Monon	Manon
Palaeogeogr	Palaeogeogn
21???	21-31
31.	.
Californi	Califomia
a.	.
Palaeontol.	PaIaeontol.
862???8	862-873
73.	.
BioL	Biol
H.M.S.O.	H.M.S.o.
55???	55-82
82.	.
N,	N.
inst	Inst
Oceanol.	oceanol.
Bi	Bz
o	'
l.,	o1.
US.S.R.	U.S.S.R.
Acad	Aead
154:	1542
Jndica	Indica
US.	U.S.
?tl.	Natl.
Pulaeonto!	Palaeontol
Palaeonlol.	Palaeontol.
928???9	928-944
44.	.
?t.	Nat
B	-
ull.	Bull
GeoL,	Geol.
327???4	327-471
71.	.
Palueozoic	Palaeozoic
Annot	Armor
61?	.61
?6	67
7.	.
Ziegier	Ziegler
K?	K.
I	1
I???	1-27
27.	.
